{
  "camera_unit_energy": 2,
  "energies_limit": 200,
  "world": [
    "# 0 0 # 2 0 0 # 2 2 0 # 0 # 0 6 # 0 # 6 # 0 0 0 # 0 0 0 # 0 0 0",
    "4 # 0 2 4 # 0 # 4 # 0 0 0 # 0 8 # 0 # 2 4 0 # 2 8 6 # 0 # 0 # #",
    "2 2 # 0 # 0 0 0 # 0 0 # 0 # 0 6 # 0 0 0 0 # 6 # # # 8 # # 0 0 0",
    "# 0 0 0 0 0 # 0 0 # 0 0 0 # 0 # 0 0 0 # 0 2 4 # 0 0 0 0 # # # 0",
    "0 0 # 0 # 2 4 # 0 0 # 0 0 # 0 0 # 0 0 0 # # 0 0 0 # # 0 6 8 0 0",
    "0 # 0 0 0 # 2 0 # 0 0 0 0 0 3 # 1 0 # 0 0 0 0 # # 2 4 # 4 # # #",
    "0 0 0 # 0 0 # 0 0 0 # 0 0 0 0 1 # 3 # 0 # # # 0 0 0 2 # 0 0 0 0",
    "# # 0 0 # 0 0 # # 0 0 # 0 0 3 # 1 0 # 0 0 0 0 0 # # 0 0 # # # 6",
    "0 0 0 0 0 # 0 0 0 0 # 0 0 0 0 0 # 0 0 0 0 # 0 0 0 0 # 0 0 0 4 0",
    "# 2 # # 0 # 2 # # 2 # 0 # 0 1 # 0 0 0 # 0 # 2 # # 2 # 0 # 2 # 2",
    "6 4 0 0 0 4 # 7 7 # 4 0 # 0 # 1 0 # 0 # 0 4 # 7 7 # 4 0 # 0 0 #",
    "# 2 # 0 0 0 # 9 9 # 0 # 0 0 1 # 5 0 0 0 # 0 # 9 9 # 0 0 0 # 0 0",
    "0 0 # 0 0 0 # 9 9 # 0 # 0 0 0 5 # 1 0 0 # 0 # 9 9 # 0 0 0 # 2 #",
    "# 0 0 # 0 4 # 7 7 # 4 0 # 0 # 0 1 # 0 # 0 4 # 7 7 # 4 0 0 0 4 6",
    "2 # 2 # 0 # 2 # # 2 # 0 # 0 0 0 # 1 0 # 0 # 2 # # 2 # 0 # # 2 #",
    "0 4 0 0 0 # 0 0 0 0 # 0 0 0 0 # 0 0 0 0 0 # 0 0 0 0 # 0 0 0 0 0",
    "6 # # # 0 0 # # 0 0 0 0 0 # 0 1 # 3 0 0 # 0 0 # # 0 0 # 0 0 # #",
    "0 0 0 0 # 2 0 0 0 # # # 0 # 3 # 1 0 0 0 0 # 0 0 0 # 0 0 # 0 0 0",
    "# # # 4 # 4 2 # # 0 0 0 0 # 0 1 # 3 0 0 0 0 0 # 0 2 # 0 0 0 # 0",
    "0 0 8 6 0 # # 0 0 0 # # 0 0 0 # 0 0 # 0 0 # 0 0 # 4 2 # 0 # 0 0",
    "0 # # # 0 0 0 0 # 4 2 0 # 0 0 0 # 0 # 0 0 0 # 0 0 # 0 0 0 0 0 #",
    "0 0 0 # # 8 # # # 6 # 0 0 0 0 # 6 0 # 0 # 0 0 # 0 0 0 # 0 # 2 2",
    "# # 0 # 0 # 6 8 2 # 0 4 2 # 0 # 8 0 # 0 0 0 # 4 # 0 # 4 2 0 # 4",
    "0 0 0 # 0 0 0 # 0 0 0 # 6 # 0 # 6 0 # 0 # 0 2 2 # 0 0 2 # 0 0 #"
  ],
  "robot_num": "4 22 0 23 1 23 4 23 27 0 30 0 31 0 27 1"
}