{
  "camera_unit_energy": 1,
  "energies_limit": 75,
  "world": [
    "0 0 0 0 0 0 0 0 0 0 0 0 0 0 0 # 0 0 0 0 0 0 0 0 0 0 0 0 0 0 0 0",
    "0 # # # # 4 # # # # # # # # # # # # # # # # # # # # 4 # # # # 0",
    "0 # # # 4 4 4 4 # 6 8 4 # 4 4 4 # 4 4 4 # 4 7 4 # 4 4 4 4 4 # 0",
    "0 # 4 4 4 # 4 # 9 6 # 7 # 6 # 6 # 7 # 6 # 6 # 7 # 4 # # # 4 # 0",
    "0 # 4 # # # 4 4 # 6 # 4 6 4 # 4 4 4 # 4 4 4 # 4 6 4 # 4 4 4 # 0",
    "0 # 4 4 4 # 4 4 4 # # 3 # 3 # 3 3 # # # # # # # # 4 # 4 # # # 0",
    "0 # # # 4 # 4 # # # # # # # # # 2 2 2 2 2 # # 4 4 4 # 4 4 4 # 0",
    "0 # 4 4 4 # 4 4 4 # 5 6 4 9 4 6 # # # # 4 4 # 4 # # # # # 4 # 0",
    "0 # 4 # # # # # 4 # 5 # # # # # # 4 4 4 4 # # 4 4 4 # 4 4 4 # 0",
    "0 # 4 4 4 # 4 4 4 # 5 3 3 # 4 # # 4 # # # # # # # 4 4 4 # # # 0",
    "0 # # # 4 # 4 # # # 5 # 4 # 4 # # 4 4 3 3 5 # 4 4 4 # 4 4 4 # 0",
    "0 # 4 4 4 # 4 4 4 # 5 # 4 4 4 9 0 # # # # 5 # 4 # # # # # 4 # 0",
    "0 # 4 # # # # # 4 # 5 # # # # 0 9 4 4 4 # 5 # 4 4 4 # 4 4 4 # 0",
    "0 # 4 4 4 # 4 4 4 # 5 3 3 4 4 # # 4 # 4 # 5 # # # 4 # 4 # # # 0",
    "0 # # # 4 4 4 # # # # # # # 4 # # 4 # 3 3 5 # 4 4 4 # 4 4 4 # 0",
    "0 # 4 4 4 # 4 4 4 # # 4 4 4 4 # # # # # # 5 # 4 # # # # # 4 # 0",
    "0 # 4 # # # # # 4 # 4 4 # # # # 6 4 9 4 6 5 # 4 4 4 # 4 4 4 # 0",
    "0 # 4 4 4 # 4 4 4 # # 2 2 2 2 2 # # # # # # # # # 4 # 4 # # # 0",
    "0 # # # 4 # 4 # # # # # # # # 3 3 # 3 # 3 # # 4 4 4 # 4 4 4 # 0",
    "0 # 4 4 4 # 4 6 4 # 4 4 4 # 4 4 4 # 4 6 4 # 6 # 4 4 # # # 4 # 0",
    "0 # 4 # # # 4 # 7 # 6 # 6 # 7 # 6 # 6 # 7 # 6 9 # 4 # 4 4 4 # 0",
    "0 # 4 4 4 4 4 # 4 7 4 # 4 4 4 # 4 4 4 # 4 8 6 # 4 4 4 4 # # # 0",
    "0 # # # # 4 # # # # # # # # # # # # # # # # # # # # 4 # # # # 0",
    "0 0 0 0 0 0 0 0 0 0 0 0 0 0 0 0 # 0 0 0 0 0 0 0 0 0 0 0 0 0 0 0"
  ],
  "robot_num": "0 11 0 10 0 9 0 8 31 12 31 13 31 14 31 15"
}