{
  "camera_unit_energy": 1,
  "energies_limit": 50,
  "world": [
    "0 0 0 0 0 0 0 0 0 0 0 0 0 0 0 0 0 0 0 0 0 0 0 0 0 0 0 0 0 0 0 0",
    "0 0 0 0 0 0 0 0 0 0 0 0 0 0 0 0 0 0 0 0 0 0 0 0 0 0 0 0 0 0 0 0",
    "0 0 # # 0 0 0 0 0 0 0 0 0 # # 0 0 0 0 0 0 0 0 0 0 0 0 0 0 0 0 0",
    "0 0 # # # 0 0 0 0 0 0 0 # # # 0 0 0 0 0 0 0 0 0 0 0 0 0 0 0 0 0",
    "0 0 # 9 3 # # 0 0 0 # # 3 9 # 0 0 0 0 0 0 0 0 0 0 0 0 0 0 0 0 0",
    "0 0 # 3 3 3 3 # # # 3 3 3 3 # 0 0 0 0 0 0 0 0 0 0 0 0 0 0 0 0 0",
    "0 0 0 # 3 3 3 3 3 3 3 3 3 # 0 0 0 0 0 0 0 0 0 # # # # 0 0 0 0 0",
    "0 0 0 0 # 3 3 3 3 3 3 3 # 0 0 0 0 0 0 0 0 # # 3 9 9 3 # # 0 0 0",
    "0 0 0 # 3 3 # 3 3 3 # 3 3 # 0 0 0 0 0 0 # 3 3 3 3 3 3 3 3 # 0 0",
    "0 0 0 # 3 3 # 3 # 3 # 3 3 # # # # 0 0 0 # 3 3 3 3 3 3 3 3 # 0 0",
    "0 0 0 # 3 9 3 # 3 # 3 9 3 # 3 9 # 0 0 # 3 3 3 3 3 3 3 3 3 3 # 0",
    "0 0 0 0 # # 3 3 3 3 3 # # 3 3 3 # 0 0 # 3 3 3 3 # # 3 3 3 3 # 0",
    "0 0 0 # 3 3 # 3 3 3 # 3 3 # 3 # # 0 0 # # 3 3 # 9 9 # 3 3 # # 0",
    "0 0 0 # 3 3 # 3 3 3 # 3 3 # 3 # 0 0 0 # 0 # 3 # 9 9 # 3 # 0 # 0",
    "0 0 0 # 3 3 3 3 3 3 3 3 3 3 3 # 0 0 0 0 # 3 3 3 # # 3 3 3 # 0 0",
    "0 0 0 # # 3 3 3 3 3 3 3 # # 3 # 0 0 0 0 # 3 3 3 3 3 3 3 3 # 0 0",
    "0 0 0 # 3 3 3 3 3 3 3 3 3 # # 0 0 0 0 0 0 # # 0 3 3 0 # # 0 0 0",
    "0 0 0 # # 3 3 3 3 3 3 3 # # 0 0 0 0 0 0 0 0 0 # # # # 0 0 0 0 0",
    "0 0 0 # 3 3 3 3 3 3 3 3 3 # 0 0 0 0 0 0 0 0 0 0 0 0 0 0 0 0 0 0",
    "0 0 0 0 # 0 3 # # # 3 0 # 0 0 0 0 0 0 0 0 0 0 0 0 0 0 0 0 0 0 0",
    "0 0 0 0 0 # # 0 0 0 # # 0 0 0 0 0 0 0 0 0 0 0 0 0 0 0 0 0 0 0 0",
    "0 0 0 0 0 0 0 0 0 0 0 0 0 0 0 0 0 0 0 0 0 0 0 0 0 0 0 0 0 0 0 0",
    "0 0 0 0 0 0 0 0 0 0 0 0 0 0 0 0 0 0 0 0 0 0 0 0 0 0 0 0 0 0 0 0",
    "0 0 0 0 0 0 0 0 0 0 0 0 0 0 0 0 0 0 0 0 0 0 0 0 0 0 0 0 0 0 0 0"
  ],
  "robot_num": "23 16 5 19 1 23 31 23 26 16 25 16 0 23 30 23"
}