{
    "camera_unit_energy": 1,
    "energies_limit": 200,
    "world": [
        "0 # 8 6 # 0 0 0 0 # 0 0 0 0 # # # # 0 0 0 0 # 0 0 0 0 # 6 8 # 0",
        "0 0 # 6 # 0 # # # # # # # 0 # 6 6 # 0 # # # # # # # 0 # 6 # 0 0",
        "# 0 # 0 # 0 # 0 0 0 0 0 # 0 # 7 7 # 0 # 0 0 0 0 0 # 0 # 0 # 0 #",
        "8 0 # 0 # 0 # # 0 # 0 # # 0 # 4 4 # 0 # # 0 # 0 # # 0 # 0 # 0 8",
        "2 # # 2 2 2 2 2 2 # 2 2 # 2 2 # # 2 2 # 2 2 # 2 2 2 2 2 2 # # 2",
        "6 2 # 2 # # # # 2 2 2 2 2 2 2 # # 2 2 2 2 2 2 2 # # # # 2 # 2 6",
        "# 2 # 2 2 2 2 2 # 2 # # # # 2 # # 2 # # # # 2 # 2 2 2 2 2 # 2 #",
        "2 4 # # # # # 6 2 4 2 2 2 2 # 6 6 # 2 2 2 2 4 2 6 # # # # # 4 2",
        "2 # # 2 2 2 2 # 6 # 2 # # 2 2 # # 2 2 # # 2 # 6 # 2 2 2 2 # # 2",
        "2 2 # 4 # # 2 8 # 4 2 # 3 1 1 # # 1 1 3 # 2 4 # 8 2 # # 4 # 2 2",
        "# 2 # 6 4 2 # 2 2 2 # 2 1 2 # 6 6 # 2 1 2 # 2 2 2 # 2 4 6 # 2 #",
        "7 5 # # # 2 2 # # 2 # 2 1 2 # 8 8 # 2 1 2 # 2 # # 2 2 # # # 5 7",
        "5 # 2 2 2 # 2 2 4 # # 2 1 2 # 8 8 # 2 1 2 # # 4 2 2 # 2 2 2 # 5",
        "2 2 2 # 2 2 4 # 2 2 # 2 1 2 # 6 6 # 2 1 2 # 2 2 # 4 2 2 # 2 2 2",
        "# # 2 # # # 2 2 2 # 2 # 3 1 1 # # 1 1 3 # 2 # 2 2 2 # # # 2 # #",
        "4 2 2 # 2 2 2 # 2 2 2 # # 2 2 # # 2 2 # # 2 2 2 # 2 2 2 # 2 2 4",
        "6 4 2 2 2 # 2 2 4 # 2 2 2 2 # 6 6 # 2 2 2 2 # 4 2 2 # 2 2 2 4 6",
        "4 2 2 # 2 # # 4 4 6 # 2 # # 2 # # 2 # # 2 # 6 4 4 # # 2 # 2 2 4",
        "# # # # 2 # 2 # 4 # # 2 # 2 2 # # 2 2 # 2 # # 4 # 2 # 2 # # # #",
        "2 2 2 # 2 # 2 2 2 # 2 2 2 2 # 6 6 # 2 2 2 2 # 2 2 2 # 2 # 2 2 2",
        "2 # 2 # 2 # 2 # # # 2 # # # # 4 4 # # # # 2 # # # 2 # 2 # 2 # 2",
        "0 # 8 # 0 # 0 0 # 0 0 0 0 # 0 # # 0 # 0 0 0 0 # 0 0 # 0 # 8 # 0",
        "0 # 6 # 0 # # 0 0 0 # 0 0 0 0 # # 0 0 0 0 # 0 0 0 # # 0 # 6 # 0",
        "0 # 6 0 0 # 0 0 0 0 0 0 # 0 0 # # 0 0 # 0 0 0 0 0 0 # 0 0 6 # 0"
    ],
    "robot_num": "0 0 31 21 31 22 31 23 31 0 0 21 0 22 0 23"
}