{
   "camera_unit_energy": 1,
   "energies_limit": 300,
   "world": [
      "0 0 0 0 0 0 0 0 0 0 0 0 0 0 0 0 0 0 0 0 0 0 0 0 0 0 0 0 0 0 0 0",
      "0 0 0 0 0 0 # 0 0 0 0 0 0 0 0 0 0 0 0 0 0 0 0 0 0 # 0 0 0 0 0 0",
      "0 0 0 0 0 # 4 4 # 0 0 0 0 # # # # # # 0 0 0 0 # 4 4 # 0 0 0 0 0",
      "0 0 0 0 # 6 4 # 0 0 0 # # 4 4 4 # 4 4 # # 0 0 0 # 4 6 # 0 0 0 0",
      "0 0 0 # 5 4 0 0 0 0 # 4 4 4 4 4 4 # 4 4 4 # 0 0 0 # 4 5 # 0 0 0",
      "0 0 # 4 4 # 0 0 0 # 4 4 4 4 # 4 4 4 # 4 4 4 # 0 0 0 # 4 4 # 0 0",
      "0 0 0 0 # 0 0 0 # 4 4 4 4 # 7 # 4 4 4 # 4 4 4 # 0 0 0 # 0 0 0 0",
      "0 0 0 0 0 0 0 # 4 4 4 4 # 7 7 7 # 4 4 # 4 4 4 4 # 0 0 0 0 0 0 0",
      "0 0 0 0 0 0 0 # 4 4 4 4 4 # 7 # 4 4 4 # 4 4 4 4 # 0 0 0 0 0 0 0",
      "0 0 0 0 0 0 # 4 4 4 4 4 4 4 # 4 4 4 # 4 4 4 4 4 4 # 0 0 0 0 0 0",
      "0 0 0 0 0 0 # 4 4 4 4 4 4 4 4 4 4 # 4 4 4 4 4 4 4 # 0 0 0 0 0 0",
      "0 0 0 0 0 0 # 4 4 4 4 4 4 4 4 4 # 4 4 4 4 4 4 4 4 # 0 0 0 0 0 0",
      "0 0 0 0 0 0 # 4 4 4 4 4 4 4 4 # 4 4 4 4 4 4 4 4 4 # 0 0 0 0 0 0",
      "0 0 0 0 0 0 # 4 4 4 4 4 4 4 # 4 4 4 4 4 4 4 4 4 4 # 0 0 0 0 0 0",
      "0 0 0 0 0 0 # 4 4 4 4 4 4 # 4 4 4 # 4 4 4 4 4 4 4 # 0 0 0 0 0 0",
      "0 0 0 0 0 0 0 # 4 4 4 4 # 4 4 4 # 7 # 4 4 4 4 4 # 0 0 0 0 0 0 0",
      "0 0 0 0 0 0 0 # 4 4 4 4 # 4 4 # 7 7 7 # 4 4 4 4 # 0 0 0 0 0 0 0",
      "0 0 0 0 # 0 0 0 # 4 4 4 # 4 4 4 # 7 # 4 4 4 4 # 0 0 0 # 0 0 0 0",
      "0 0 # 4 4 # 0 0 0 # 4 4 4 # 4 4 4 # 4 4 4 4 # 0 0 0 # 4 4 # 0 0",
      "0 0 0 # 5 4 # 0 0 0 # 4 4 4 # 4 4 4 4 4 4 # 0 0 0 0 4 5 # 0 0 0",
      "0 0 0 0 0 6 4 # 0 0 0 # # 4 4 # 4 4 4 # # 0 0 0 # 4 6 0 0 0 0 0",
      "0 0 0 0 0 # 4 4 # 0 0 0 0 # # # # # # 0 0 0 0 # 4 4 # 0 0 0 0 0",
      "0 0 0 0 0 0 # 0 0 0 0 0 0 0 0 0 0 0 0 0 0 0 0 0 0 # 0 0 0 0 0 0",
      "0 0 0 0 0 0 0 0 0 0 0 0 0 0 0 0 0 0 0 0 0 0 0 0 0 0 0 0 0 0 0 0"
   ],
   "robot_num": "26 4 14 7 20 11 5 19 5 4 11 12 17 16 26 19"
}