{
  "camera_unit_energy": 5,
  "energies_limit": 350,
  "world": [
    "0 0 0 # 0 0 0 0 0 # 0 0 0 # 0 0 0 0 # 0 0 0 # 0 0 0 0 0 # 0 0 0",
    "0 0 0 # 0 # 0 0 0 # 0 # 0 # 0 0 0 0 # 0 # 0 # 0 0 0 # 0 # 0 0 0",
    "0 0 0 # 0 # 0 0 0 # 0 # 0 # 0 0 0 0 # 0 # 0 # 0 0 0 # 0 # 0 0 0",
    "0 # # # 0 # 0 # # # 0 # 0 # 0 0 0 0 # 0 # 0 # # # 0 # 0 # # # 0",
    "0 0 0 0 0 # 0 # 0 0 0 # 0 # 0 # # 0 # 0 # 0 0 0 # 0 # 0 0 0 0 0",
    "# # # # # # 0 # 0 0 0 # 0 # 0 # # 0 # 0 # 0 0 0 # 0 # # # # # #",
    "0 0 0 0 0 0 0 # 0 0 0 # 0 0 0 # # 0 0 0 # 0 0 0 # 0 0 0 0 0 0 0",
    "0 # # # # # # # 0 # # # # # 0 # # 0 # # # # # 0 # # # # # # # 0",
    "0 0 0 0 0 0 0 0 0 # 0 0 0 0 0 0 0 0 0 0 0 0 # 0 0 0 0 0 0 0 0 0",
    "0 0 0 # # # # # # # 0 0 0 0 4 4 4 4 0 0 0 0 # # # # # # # 0 0 0",
    "0 0 0 # 0 0 0 0 4 0 0 0 0 4 # # # # 4 0 0 0 0 4 0 0 0 0 # 0 0 0",
    "# # # # 0 0 0 4 # 4 0 0 4 # 4 4 4 4 # 4 0 0 4 # 4 0 0 0 # # # #",
    "0 0 0 0 0 0 4 # 4 # 4 4 # 4 4 # # 4 4 # 4 4 # 4 # 4 0 0 0 0 0 0",
    "0 0 0 0 0 4 # 4 4 4 # # 4 7 4 4 4 4 7 4 # # 4 4 4 # 4 0 0 0 0 0",
    "0 0 0 0 4 # 4 4 7 4 4 4 4 4 4 4 4 4 4 4 4 4 4 7 4 4 # 4 0 0 0 0",
    "0 0 0 0 4 # 4 4 4 4 # # # # # # # # # # # # 4 4 4 4 # 4 0 0 0 0",
    "0 0 0 4 # 4 4 4 4 # 4 4 4 4 4 4 4 4 4 4 4 4 # 4 4 4 4 # 4 0 0 0",
    "0 0 4 # 4 4 4 4 # 4 5 5 # 5 5 5 5 5 5 # 5 5 4 # 4 4 4 4 # 4 0 0",
    "0 0 4 # 4 4 7 4 # 4 5 # 7 # 5 5 5 5 # 7 # 5 4 # 4 7 4 4 # 4 0 0",
    "0 0 4 # 4 4 4 4 # 4 5 5 # 5 5 5 5 5 5 # 5 5 4 # 4 4 4 4 # 4 0 0",
    "0 0 0 4 # 4 4 4 4 # 4 4 4 4 4 4 4 4 4 4 4 4 # 4 4 4 4 # 4 0 0 0",
    "0 0 0 0 4 # 4 4 4 4 # # # # # 0 0 # # # # # 4 4 4 4 # 4 0 0 0 0",
    "0 0 0 0 0 4 # 4 4 4 4 4 4 4 4 4 4 4 4 4 4 4 4 4 4 # 4 0 0 0 0 0",
    "0 0 0 0 0 0 4 # 7 4 4 2 2 4 4 4 4 4 4 2 2 4 4 7 # 4 0 0 0 0 0 0"
  ],
  "robot_num": "0 0 31 1 15 8 16 11 0 1 31 0 15 20 16 8"
}