{
  "camera_unit_energy": 3,
  "energies_limit": 350,
  "world": [
    "0 0 0 0 0 0 0 0 0 0 0 0 0 0 0 0 0 0 0 0 0 0 0 0 0 0 0 0 0 0 0 0",
    "0 0 0 0 0 0 0 0 0 0 0 0 0 # # # # # # 0 0 0 0 0 0 0 0 0 0 0 0 0",
    "0 0 0 0 0 0 0 0 0 0 0 0 # 3 3 3 3 3 3 # # 0 0 0 0 0 0 0 0 0 0 0",
    "0 0 0 0 0 0 0 0 0 0 0 # 3 3 3 3 3 3 3 3 # 0 0 0 0 0 0 0 0 0 0 0",
    "0 0 0 0 0 0 0 0 0 # # 3 3 3 3 3 3 3 3 3 3 # # 0 0 0 0 0 0 0 0 0",
    "0 0 0 0 0 0 0 0 0 # 3 3 3 3 3 3 3 3 3 3 3 3 # 0 0 0 0 0 0 0 0 0",
    "0 0 0 0 0 # # # # 3 3 3 3 # # # # # # 3 3 3 # # 0 0 0 0 0 0 0 0",
    "0 0 0 # # 3 3 3 3 3 3 3 # 3 3 3 3 3 3 3 3 3 3 3 # # # 0 0 0 0 0",
    "0 0 0 # 3 3 3 3 3 3 3 # 3 3 # # # # 3 3 # 3 3 3 3 3 3 # 0 0 0 0",
    "0 0 0 # 3 3 3 3 3 3 3 # 3 # 0 0 0 0 # 3 # 3 3 3 3 3 3 # 0 0 0 0",
    "0 0 0 0 # 3 3 3 3 3 3 # 3 # 0 0 0 0 # 3 # 3 3 3 3 3 # 0 0 0 0 0",
    "0 0 0 0 0 # # # # # # # 3 # # # # # # 3 # # # # # # 0 0 0 0 0 0",
    "0 0 0 0 0 0 0 0 0 0 0 # 3 # 0 0 0 0 # 3 # 0 0 0 0 0 0 0 0 0 0 0",
    "0 0 0 0 0 0 0 0 0 0 0 # 3 # 0 0 0 0 # 3 # 0 0 0 0 0 0 0 0 0 0 0",
    "0 0 0 0 0 # # # # # # # 3 # # # # # # 3 # # # # # # # 0 0 0 0 0",
    "0 0 0 0 0 # 3 3 3 3 3 3 3 3 3 3 3 3 3 3 3 3 3 3 3 3 # 0 0 0 0 0",
    "0 0 0 0 0 # 3 3 3 3 3 3 3 3 3 # # 3 3 3 3 3 3 3 3 3 # 0 0 0 0 0",
    "0 0 0 0 0 # 3 3 3 3 3 3 3 3 # 7 7 # 3 3 3 3 3 3 3 3 # 0 0 0 0 0",
    "0 0 0 0 0 # 3 3 3 3 3 3 3 3 # 7 7 # 3 3 3 3 3 3 3 3 # 0 0 0 0 0",
    "0 0 0 0 0 # 3 3 3 3 3 3 3 3 3 # # 3 3 3 3 3 3 3 3 3 # 0 0 0 0 0",
    "0 0 0 0 0 # 3 3 3 3 3 3 3 3 3 3 3 3 3 3 3 3 3 3 3 3 # 0 0 0 0 0",
    "0 0 0 0 0 # 3 3 3 3 3 3 3 3 3 3 3 3 3 3 3 3 3 3 3 3 # 0 0 0 0 0",
    "0 0 0 0 0 # # # # # # # # # # # # # # # # # # # # # # 0 0 0 0 0",
    "0 0 0 0 0 0 0 0 0 0 0 0 0 0 0 0 0 0 0 0 0 0 0 0 0 0 0 0 0 0 0 0"
  ],
  "robot_num": "0 0 31 0 6 21 25 21 13 2 18 2 0 23 31 23"
}