{
   "camera_unit_energy": 5,
   "energies_limit": 50,
   "world": [
      "0 0 0 0 0 0 0 0 0 0 0 0 0 0 0 0 0 0 0 0 0 0 0 0 0 0 0 0 0 0 0 0",
      "0 0 0 0 0 0 0 0 0 0 0 0 0 0 0 0 0 0 0 0 0 0 0 0 0 0 0 0 0 0 0 0",
      "0 0 0 0 0 0 0 0 0 0 0 0 0 0 0 0 0 0 0 0 0 0 # # # # 0 0 0 0 0 0",
      "0 0 0 0 0 0 0 0 0 0 0 0 0 0 0 0 0 0 0 0 # # # 4 4 # # # 0 0 0 0",
      "0 0 0 0 0 0 0 0 0 0 0 0 0 0 0 0 0 0 # # # 4 4 4 4 4 4 # # # 0 0",
      "0 # # # # # # # # # # # # # # # 0 # # 4 4 4 # # # # 4 4 4 # # 0",
      "0 # 4 4 4 4 4 4 4 4 4 4 4 4 4 # 0 # 4 4 4 # 8 8 8 8 # 4 4 4 # 0",
      "0 # 4 4 4 # # 4 4 4 4 4 4 4 4 # 0 # 4 4 4 # 8 8 8 8 # 4 4 4 # 0",
      "0 # 4 4 # 8 8 # 4 4 # # # # 4 # 0 # 4 4 4 # 8 8 8 8 # 4 4 4 # 0",
      "0 # 4 4 # 8 8 # 4 4 4 4 4 4 4 # 0 # 4 4 4 4 # # # # 4 4 4 4 # 0",
      "0 # 4 4 4 # # 4 4 4 # # # # 4 # 0 # # 4 4 4 4 # 4 4 4 4 4 # # 0",
      "0 # 4 4 4 # # 4 4 4 4 4 4 4 4 # 0 0 # 4 4 4 4 # 4 4 4 4 4 # 0 0",
      "0 # 4 4 # 8 8 # 4 4 # # # # 4 # 0 0 # 4 4 4 4 # # # 4 4 4 # 0 0",
      "0 # 4 # 8 8 8 8 # 4 4 4 4 4 4 # 0 0 # # 4 4 4 # 4 4 4 4 # # 0 0",
      "0 # 4 # # # # # # 4 4 4 4 4 4 # 0 0 0 # 4 4 4 # # # 4 4 # 0 0 0",
      "0 # 4 4 4 4 4 4 4 4 4 4 4 4 4 # 0 0 0 # # 4 4 # 4 4 4 # # 0 0 0",
      "0 # 4 4 4 4 4 4 4 4 4 4 4 4 4 # 0 0 0 0 # 4 4 4 4 4 4 # 0 0 0 0",
      "0 # # # # # # # # # # # # # # # 0 0 0 0 # # 4 4 4 4 # # 0 0 0 0",
      "0 0 0 0 0 0 0 0 0 0 0 0 0 0 0 0 0 0 0 0 0 # # 4 4 # # 0 0 0 0 0",
      "0 0 0 0 0 0 0 0 0 0 0 0 0 0 0 0 0 0 0 0 0 0 # # # # 0 0 0 0 0 0",
      "0 0 0 0 0 0 0 0 0 0 0 0 0 0 0 0 0 0 0 0 0 0 0 0 0 0 0 0 0 0 0 0",
      "0 0 0 0 0 0 0 0 0 0 0 0 0 0 0 0 0 0 0 0 0 0 0 0 0 0 0 0 0 0 0 0",
      "0 0 0 0 0 0 0 0 0 0 0 0 0 0 0 0 0 0 0 0 0 0 0 0 0 0 0 0 0 0 0 0",
      "0 0 0 0 0 0 0 0 0 0 0 0 0 0 0 0 0 0 0 0 0 0 0 0 0 0 0 0 0 0 0 0"
   ],
   "robot_num": "31 0 14 6 23 7 0 23 0 0 5 13 24 18 31 23"
}