{
  "camera_unit_energy": 2,
  "energies_limit": 300,
  "world": [
    "# # 0 0 0 0 0 0 0 0 0 0 0 0 0 0 0 0 0 0 0 0 0 0 0 0 0 0 0 0 # #",
    "# # 0 0 0 0 0 0 0 0 0 0 0 0 0 0 0 0 0 0 0 0 0 0 0 0 0 0 0 0 # #",
    "0 0 # 0 0 # # # # # # # # # # # # # # # # # # # # # # # # # 0 0",
    "0 0 # 0 0 1 1 1 1 1 1 1 1 1 1 1 1 1 1 1 1 1 1 1 1 1 1 0 0 0 0 0",
    "0 0 # 0 0 1 1 0 0 0 0 0 0 0 0 0 0 0 0 0 0 0 0 0 0 1 1 0 0 0 0 0",
    "0 0 # 0 0 1 1 0 0 # 0 0 0 0 0 0 0 0 0 0 0 0 # 0 0 1 1 0 0 # 0 0",
    "0 0 # 0 0 1 1 0 0 0 # 4 4 4 4 4 4 4 4 4 4 # 0 0 0 1 1 0 0 # 0 0",
    "0 0 # 0 0 1 1 0 0 0 4 # 5 5 5 5 5 5 5 5 # 4 0 0 0 1 1 0 0 # 0 0",
    "0 0 # 0 0 1 1 0 0 0 4 5 # 6 6 6 6 6 6 # 5 4 0 0 0 1 1 0 0 # 0 0",
    "0 0 # 0 0 1 1 0 0 0 4 5 6 # 7 7 7 7 # 6 5 4 0 0 0 1 1 0 0 # 0 0",
    "0 0 # 0 0 1 1 0 0 0 4 5 6 7 # 0 # # 7 6 5 4 0 0 0 1 1 0 0 # 0 0",
    "0 0 # 0 0 1 1 0 0 0 4 5 6 7 # 9 9 0 7 6 5 4 0 0 0 1 1 0 0 # 0 0",
    "0 0 # 0 0 1 1 0 0 0 4 5 6 7 0 9 9 # 7 6 5 4 0 0 0 1 1 0 0 # 0 0",
    "0 0 # 0 0 1 1 0 0 0 4 5 6 7 # # 0 # 7 6 5 4 0 0 0 1 1 0 0 # 0 0",
    "0 0 # 0 0 1 1 0 0 0 4 5 6 # 7 7 7 7 # 6 5 4 0 0 0 1 1 0 0 # 0 0",
    "0 0 # 0 0 1 1 0 0 0 4 5 # 6 6 6 6 6 6 # 5 4 0 0 0 1 1 0 0 # 0 0",
    "0 0 # 0 0 1 1 0 0 0 4 # 5 5 5 5 5 5 5 5 # 4 0 0 0 1 1 0 0 # 0 0",
    "0 0 # 0 0 1 1 0 0 0 # 4 4 4 4 4 4 4 4 4 4 # 0 0 0 1 1 0 0 # 0 0",
    "0 0 # 0 0 1 1 0 0 # 0 0 0 0 0 0 0 0 0 0 0 0 # 0 0 1 1 0 0 # 0 0",
    "0 0 0 0 0 1 1 0 0 0 0 0 0 0 0 0 0 0 0 0 0 0 0 0 0 1 1 0 0 # 0 0",
    "0 0 0 0 0 1 1 1 1 1 1 1 1 1 1 1 1 1 1 1 1 1 1 1 1 1 1 0 0 # 0 0",
    "0 0 # # # # # # # # # # # # # # # # # # # # # # # # # 0 0 # 0 0",
    "# # 0 0 0 0 0 0 0 0 0 0 0 0 0 0 0 0 0 0 0 0 0 0 0 0 0 0 0 0 # #",
    "# # 0 0 0 0 0 0 0 0 0 0 0 0 0 0 0 0 0 0 0 0 0 0 0 0 0 0 0 0 # #"
  ],
  "robot_num": "29 0 1 2 31 21 2 22 29 1 0 2 30 21 2 23"
}