{
    "world": [
        "1 1 1 1 1 1 1 1 1 1 1 1 1 1 1 1 1 1 1 1 1 1 1 1 1 1 1 1 1 1 1 1",
        "1 * * # * * * * * # * * # * * * * * * * # * * * * * # * * * * 1",
        "1 * * * # 4 4 4 # * * * # * * * * * * * * # 4 4 4 # * * * * * 1",
        "1 * * * 4 # 7 # 4 * * * # * 6 6 6 * * * * 4 # 7 # 3 * * * * * 1",
        "1 * * * 4 7 # 7 4 * * * # * 6 5 6 * * * * 4 7 # 7 4 * * * * * 1",
        "1 * * * 3 3 # 3 3 * * * # * 6 6 6 * * * * 3 3 # 3 3 * * * * * 1",
        "1 * * * * * # * * * * * # * * * * * * * * * * # * * * * * * * 1",
        "1 * * * * * # * * * * * # * * * * * * * * * * # * * * * * * * 1",
        "1 * * * * * # * * * * * # # # # # # * * * * * # * * * * * * * 1",
        "1 * * * * * * * * * * * * * * * * * * * * * * * * * * * * * * 1",
        "1 * * * * * * * * * * # # # * # # # * * * * * * * * * * * * * 1",
        "1 * * * A F * * * * # 8 8 8 # 8 8 8 # * * * * * * * * G D * * 1",
        "1 * * * E B * * * * * # 8 * 9 * 8 # * * * * * * * * * C H * * 1",
        "1 * * * * * * * * * * * # 8 * 8 # * * * * * * * * * * * * * * 1",
        "1 * * * * * * * * * * * * # 8 # * * * * * * * * * * * * * * * 1",
        "1 * * * * # # # # # * * # * # * * * * * # * * * * * # * * * * 1",
        "1 * * * # * * * * * * * # * * * * * * * * # 4 4 4 # * * * * * 1",
        "1 * * # * * * 2 2 2 * * # * 6 6 6 * * * * 4 # 7 # 4 * * * * * 1",
        "1 * * # * * * 2 2 2 * * # * 6 5 6 * * * * 4 7 # 7 4 * * * * * 1",
        "1 * * # * * * 2 2 2 * * # * 6 6 6 * * * * 3 3 # 3 3 * * * * * 1",
        "1 * * # * * * 2 2 2 * * # * * * * * * * * * * # * * * * * * * 1",
        "1 * * * # * * * * * * * # * * * * * * * * * * # * * * * * * * 1",
        "1 * * * * # # # # # * * # # # # # # * * * * * # * * * * * * * 1",
        "1 1 1 1 1 1 1 1 1 1 1 1 1 1 1 1 1 1 1 1 1 1 1 1 1 1 1 1 1 1 1 1"
    ],
    "robot_num": 4,
    "random_seed": 8,
    "random_area": [
        "0 0 14 10 0.05",
        "0 18 14 31 0.05",
        "15 0 23 31 0.05"
    ]
}